//MAP CONVERTED BY dmm2tgm.py THIS HEADER COMMENT PREVENTS RECONVERSION, DO NOT REMOVE
"a" = (
/turf/open/lava,
/area/deathmatch/fullbright)
"b" = (
/obj/structure/stone_tile/block{
	dir = 1
	},
/obj/structure/stone_tile/block,
/turf/open/lava,
/area/deathmatch/fullbright)
"c" = (
/obj/structure/stone_tile{
	dir = 8
	},
/turf/open/lava,
/area/deathmatch/fullbright)
"e" = (
/turf/closed/indestructible/wood,
/area/deathmatch/fullbright)
"f" = (
/obj/structure/stone_tile/block{
	dir = 4
	},
/turf/open/lava,
/area/deathmatch/fullbright)
"g" = (
/obj/structure/stone_tile/surrounding_tile{
	dir = 8
	},
/turf/open/chasm/true,
/area/deathmatch/fullbright)
"h" = (
/obj/structure/stone_tile/block,
/turf/open/lava,
/area/deathmatch/fullbright)
"i" = (
/turf/open/floor/engine/cult,
/area/deathmatch/fullbright)
"l" = (
/obj/structure/stone_tile,
/obj/structure/stone_tile{
	dir = 4
	},
/obj/structure/stone_tile{
	dir = 8
	},
/turf/open/lava,
/area/deathmatch/fullbright)
"o" = (
/obj/structure/stone_tile/surrounding,
/turf/open/lava,
/area/deathmatch/fullbright)
"q" = (
/obj/structure/stone_tile{
	dir = 4
	},
/turf/open/lava,
/area/deathmatch/fullbright)
"r" = (
/obj/structure/stone_tile{
	dir = 1
	},
/turf/open/lava,
/area/deathmatch/fullbright)
"t" = (
/obj/structure/stone_tile{
	dir = 4
	},
/obj/structure/stone_tile{
	dir = 8
	},
/obj/structure/stone_tile{
	dir = 1
	},
/turf/open/lava,
/area/deathmatch/fullbright)
"u" = (
/obj/structure/bonfire/prelit,
/turf/open/floor/engine/cult,
/area/deathmatch/fullbright)
"w" = (
/obj/effect/landmark/deathmatch_player_spawn,
/turf/open/floor/engine/cult,
/area/deathmatch/fullbright)
"x" = (
/obj/structure/stone_tile/block{
	dir = 8
	},
/turf/open/lava,
/area/deathmatch/fullbright)
"A" = (
/obj/structure/stone_tile{
	dir = 1
	},
/obj/structure/stone_tile{
	dir = 8
	},
/obj/structure/stone_tile,
/turf/open/lava,
/area/deathmatch/fullbright)
"D" = (
/obj/structure/stone_tile/surrounding_tile,
/turf/open/chasm/true,
/area/deathmatch/fullbright)
"F" = (
/obj/structure/stone_tile/block{
	dir = 1
	},
/turf/open/lava,
/area/deathmatch/fullbright)
"H" = (
/obj/structure/stone_tile,
/turf/open/lava,
/area/deathmatch/fullbright)
"I" = (
/obj/structure/stone_tile/surrounding_tile{
	dir = 1
	},
/turf/open/chasm/true,
/area/deathmatch/fullbright)
"J" = (
/obj/structure/stone_tile/surrounding_tile{
	dir = 4
	},
/turf/open/chasm/true,
/area/deathmatch/fullbright)
"L" = (
/obj/item/organ/internal/cyberimp/brain/anti_drop,
/turf/open/floor/engine/cult,
/area/deathmatch/fullbright)
"M" = (
/obj/machinery/field/generator/starts_on{
	active_power_usage = 0;
	idle_power_usage = 0;
	power = 9999
	},
/turf/open/floor/engine/cult,
/area/deathmatch/fullbright)
"N" = (
/turf/open/chasm/true,
/area/deathmatch/fullbright)
"R" = (
/obj/structure/emergency_shield/cult/barrier,
/turf/open/floor/engine/cult,
/area/deathmatch/fullbright)
"S" = (
/obj/structure/showcase/wizard,
/turf/open/floor/engine/cult,
/area/deathmatch/fullbright)
"W" = (
/obj/structure/stone_tile,
/obj/structure/stone_tile{
	dir = 4
	},
/obj/structure/stone_tile{
	dir = 1
	},
/turf/open/lava,
/area/deathmatch/fullbright)
"Y" = (
/obj/structure/stone_tile/block{
	dir = 8
	},
/obj/structure/stone_tile/block{
	dir = 4
	},
/turf/open/lava,
/area/deathmatch/fullbright)

(1,1,1) = {"
e
e
e
e
e
e
e
e
e
e
e
e
e
e
e
e
e
e
e
e
e
e
e
e
e
e
e
e
e
e
e
e
e
e
e
e
e
e
e
e
e
"}
(2,1,1) = {"
e
N
N
N
N
N
N
N
N
N
N
N
N
N
N
N
N
N
N
N
N
N
N
N
N
N
N
N
N
N
N
N
N
N
N
N
N
N
N
N
e
"}
(3,1,1) = {"
e
N
N
N
N
N
N
N
N
N
N
N
N
N
N
N
N
N
N
N
N
N
N
N
N
N
N
N
N
N
N
N
N
N
N
N
N
N
N
N
e
"}
(4,1,1) = {"
e
N
N
N
N
N
N
N
N
N
N
N
N
N
N
N
N
N
N
N
N
N
N
N
N
N
N
N
N
N
N
N
N
N
N
N
N
N
N
N
e
"}
(5,1,1) = {"
e
N
N
N
M
i
i
i
i
i
i
i
M
i
i
i
i
i
i
i
M
i
i
i
i
i
i
i
M
i
i
i
i
i
i
i
M
N
N
N
e
"}
(6,1,1) = {"
e
N
N
N
i
A
f
f
f
f
f
f
f
f
f
f
f
f
f
f
f
f
f
f
f
f
f
f
f
f
f
f
f
f
f
W
i
N
N
N
e
"}
(7,1,1) = {"
e
N
N
N
i
h
a
a
a
a
a
a
a
a
a
a
a
a
a
a
a
a
a
a
a
a
a
a
a
a
a
a
a
a
a
F
i
N
N
N
e
"}
(8,1,1) = {"
e
N
N
N
i
h
a
q
x
x
x
x
x
x
x
x
x
x
x
x
x
x
x
x
x
x
x
x
x
x
x
x
x
c
a
F
i
N
N
N
e
"}
(9,1,1) = {"
e
N
N
N
i
h
a
F
i
i
i
i
i
i
i
i
i
i
i
i
b
i
i
i
i
i
i
i
i
i
i
i
i
h
a
F
i
N
N
N
e
"}
(10,1,1) = {"
e
N
N
N
i
h
a
F
i
i
i
i
i
i
i
i
w
i
i
i
b
i
i
i
w
i
i
i
i
i
i
i
i
h
a
F
i
N
N
N
e
"}
(11,1,1) = {"
e
N
N
N
i
h
a
F
i
i
i
i
i
i
i
i
i
i
i
i
b
i
i
i
i
i
i
i
i
i
i
i
i
h
a
F
i
N
N
N
e
"}
(12,1,1) = {"
e
N
N
N
i
h
a
F
i
i
i
i
i
i
i
i
i
i
i
i
b
i
i
i
i
i
i
i
i
i
i
i
i
h
a
F
i
N
N
N
e
"}
(13,1,1) = {"
e
N
N
N
M
h
a
F
i
i
i
i
o
Y
Y
Y
Y
Y
Y
Y
o
Y
Y
Y
Y
Y
Y
Y
o
i
i
i
i
h
a
F
M
N
N
N
e
"}
(14,1,1) = {"
e
N
N
N
i
h
a
F
i
i
i
i
b
R
R
R
R
R
R
R
R
R
R
R
R
R
R
R
b
i
i
i
i
h
a
F
i
N
N
N
e
"}
(15,1,1) = {"
e
N
N
N
i
h
a
F
i
i
i
i
b
R
N
N
N
N
N
N
N
N
N
N
N
N
N
R
b
i
i
i
i
h
a
F
i
N
N
N
e
"}
(16,1,1) = {"
e
N
N
N
i
h
a
F
i
i
i
i
b
R
N
N
N
N
N
N
N
N
N
N
N
N
N
R
b
i
i
i
i
h
a
F
i
N
N
N
e
"}
(17,1,1) = {"
e
N
N
N
i
h
a
F
i
w
i
i
b
R
N
N
N
N
N
N
N
N
N
N
N
N
N
R
b
i
i
w
i
h
a
F
i
N
N
N
e
"}
(18,1,1) = {"
e
N
N
N
i
h
a
F
i
i
i
i
b
R
N
N
N
N
N
N
N
N
N
N
N
N
N
R
b
i
i
i
i
h
a
F
i
N
N
N
e
"}
(19,1,1) = {"
e
N
N
N
i
h
a
F
i
i
i
i
b
R
N
N
N
N
N
J
u
g
N
N
N
N
N
R
b
i
i
i
i
h
a
F
i
N
N
N
e
"}
(20,1,1) = {"
e
N
N
N
i
h
a
F
i
i
i
i
b
R
N
N
N
N
J
L
i
i
g
N
N
N
N
R
b
i
i
i
i
h
a
F
i
N
N
N
e
"}
(21,1,1) = {"
e
N
N
N
M
h
a
F
Y
Y
Y
Y
o
R
N
N
N
N
u
i
S
i
u
N
N
N
N
R
o
Y
Y
Y
Y
h
a
F
M
N
N
N
e
"}
(22,1,1) = {"
e
N
N
N
i
h
a
F
i
i
i
i
b
R
N
N
N
N
I
i
i
i
D
N
N
N
N
R
b
i
i
i
i
h
a
F
i
N
N
N
e
"}
(23,1,1) = {"
e
N
N
N
i
h
a
F
i
i
i
i
b
R
N
N
N
N
N
I
u
D
N
N
N
N
N
R
b
i
i
i
i
h
a
F
i
N
N
N
e
"}
(24,1,1) = {"
e
N
N
N
i
h
a
F
i
i
i
i
b
R
N
N
N
N
N
N
N
N
N
N
N
N
N
R
b
i
i
i
i
h
a
F
i
N
N
N
e
"}
(25,1,1) = {"
e
N
N
N
i
h
a
F
i
w
i
i
b
R
N
N
N
N
N
N
N
N
N
N
N
N
N
R
b
i
i
w
i
h
a
F
i
N
N
N
e
"}
(26,1,1) = {"
e
N
N
N
i
h
a
F
i
i
i
i
b
R
N
N
N
N
N
N
N
N
N
N
N
N
N
R
b
i
i
i
i
h
a
F
i
N
N
N
e
"}
(27,1,1) = {"
e
N
N
N
i
h
a
F
i
i
i
i
b
R
N
N
N
N
N
N
N
N
N
N
N
N
N
R
b
i
i
i
i
h
a
F
i
N
N
N
e
"}
(28,1,1) = {"
e
N
N
N
i
h
a
F
i
i
i
i
b
R
R
R
R
R
R
R
R
R
R
R
R
R
R
R
b
i
i
i
i
h
a
F
i
N
N
N
e
"}
(29,1,1) = {"
e
N
N
N
M
h
a
F
i
i
i
i
o
Y
Y
Y
Y
Y
Y
Y
o
Y
Y
Y
Y
Y
Y
Y
o
i
i
i
i
h
a
F
M
N
N
N
e
"}
(30,1,1) = {"
e
N
N
N
i
h
a
F
i
i
i
i
i
i
i
i
i
i
i
i
b
i
i
i
i
i
i
i
i
i
i
i
i
h
a
F
i
N
N
N
e
"}
(31,1,1) = {"
e
N
N
N
i
h
a
F
i
i
i
i
i
i
i
i
i
i
i
i
b
i
i
i
i
i
i
i
i
i
i
i
i
h
a
F
i
N
N
N
e
"}
(32,1,1) = {"
e
N
N
N
i
h
a
F
i
i
i
i
i
i
i
i
w
i
i
i
b
i
i
i
w
i
i
i
i
i
i
i
i
h
a
F
i
N
N
N
e
"}
(33,1,1) = {"
e
N
N
N
i
h
a
F
i
i
i
i
i
i
i
i
i
i
i
i
b
i
i
i
i
i
i
i
i
i
i
i
i
h
a
F
i
N
N
N
e
"}
(34,1,1) = {"
e
N
N
N
i
h
a
r
f
f
f
f
f
f
f
f
f
f
f
f
f
f
f
f
f
f
f
f
f
f
f
f
f
H
a
F
i
N
N
N
e
"}
(35,1,1) = {"
e
N
N
N
i
h
a
a
a
a
a
a
a
a
a
a
a
a
a
a
a
a
a
a
a
a
a
a
a
a
a
a
a
a
a
F
i
N
N
N
e
"}
(36,1,1) = {"
e
N
N
N
i
l
x
x
x
x
x
x
x
x
x
x
x
x
x
x
x
x
x
x
x
x
x
x
x
x
x
x
x
x
x
t
i
N
N
N
e
"}
(37,1,1) = {"
e
N
N
N
M
i
i
i
i
i
i
i
M
i
i
i
i
i
i
i
M
i
i
i
i
i
i
i
M
i
i
i
i
i
i
i
M
N
N
N
e
"}
(38,1,1) = {"
e
N
N
N
N
N
N
N
N
N
N
N
N
N
N
N
N
N
N
N
N
N
N
N
N
N
N
N
N
N
N
N
N
N
N
N
N
N
N
N
e
"}
(39,1,1) = {"
e
N
N
N
N
N
N
N
N
N
N
N
N
N
N
N
N
N
N
N
N
N
N
N
N
N
N
N
N
N
N
N
N
N
N
N
N
N
N
N
e
"}
(40,1,1) = {"
e
N
N
N
N
N
N
N
N
N
N
N
N
N
N
N
N
N
N
N
N
N
N
N
N
N
N
N
N
N
N
N
N
N
N
N
N
N
N
N
e
"}
(41,1,1) = {"
e
e
e
e
e
e
e
e
e
e
e
e
e
e
e
e
e
e
e
e
e
e
e
e
e
e
e
e
e
e
e
e
e
e
e
e
e
e
e
e
e
"}
