//MAP CONVERTED BY dmm2tgm.py THIS HEADER COMMENT PREVENTS RECONVERSION, DO NOT REMOVE
"a" = (
/turf/open/indestructible/dark/smooth_large,
/area/deathmatch/fullbright)
"b" = (
/obj/effect/turf_decal/tile/yellow/full,
/turf/open/indestructible/dark/smooth_large,
/area/deathmatch/fullbright)
"c" = (
/turf/closed/indestructible/riveted,
/area/deathmatch/fullbright)
"e" = (
/obj/structure/cable,
/turf/closed/indestructible/riveted,
/area/deathmatch/fullbright)
"f" = (
/obj/effect/turf_decal/tile/dark_red/half{
	dir = 8
	},
/turf/open/indestructible/dark/smooth_large,
/area/deathmatch/fullbright)
"h" = (
/obj/effect/turf_decal/tile/yellow/half{
	dir = 1
	},
/turf/open/indestructible/dark/smooth_large,
/area/deathmatch/fullbright)
"i" = (
/obj/item/mjollnir,
/turf/open/indestructible/dark/smooth_large,
/area/deathmatch/fullbright)
"l" = (
/obj/effect/turf_decal/tile/dark_red/anticorner{
	dir = 4
	},
/turf/open/indestructible/dark/smooth_large,
/area/deathmatch/fullbright)
"o" = (
/obj/effect/landmark/deathmatch_player_spawn,
/turf/open/indestructible/dark/smooth_large,
/area/deathmatch/fullbright)
"p" = (
/obj/structure/cable,
/obj/structure/lattice,
/turf/open/chasm/true,
/area/deathmatch/fullbright)
"q" = (
/obj/effect/turf_decal/tile/dark_red/half,
/turf/open/indestructible/dark/smooth_large,
/area/deathmatch/fullbright)
"r" = (
/obj/structure/cable,
/obj/effect/turf_decal/tile/dark_red/full,
/turf/open/indestructible/dark/smooth_large,
/area/deathmatch/fullbright)
"s" = (
/obj/structure/trap/chill,
/obj/effect/turf_decal/tile/yellow/full,
/turf/open/indestructible/dark/smooth_large,
/area/deathmatch/fullbright)
"t" = (
/obj/effect/turf_decal/tile/dark_red/anticorner,
/turf/open/indestructible/dark/smooth_large,
/area/deathmatch/fullbright)
"u" = (
/obj/effect/turf_decal/tile/yellow/half{
	dir = 4
	},
/turf/open/indestructible/dark/smooth_large,
/area/deathmatch/fullbright)
"w" = (
/obj/effect/turf_decal/tile/dark_red/half{
	dir = 1
	},
/turf/open/indestructible/dark/smooth_large,
/area/deathmatch/fullbright)
"x" = (
/obj/effect/turf_decal/tile/dark_red/half{
	dir = 4
	},
/turf/open/indestructible/dark/smooth_large,
/area/deathmatch/fullbright)
"y" = (
/obj/structure/cable,
/obj/machinery/power/rtg/advanced{
	power_gen = 50000
	},
/obj/structure/lattice/catwalk,
/turf/open/indestructible/plating,
/area/deathmatch/fullbright)
"z" = (
/obj/machinery/field/generator/starts_on,
/obj/structure/cable,
/obj/structure/cable,
/obj/effect/turf_decal/tile/dark_red/full,
/turf/open/indestructible/dark/smooth_large,
/area/deathmatch/fullbright)
"A" = (
/obj/effect/turf_decal/tile/dark_red/anticorner{
	dir = 1
	},
/turf/open/indestructible/dark/smooth_large,
/area/deathmatch/fullbright)
"D" = (
/obj/effect/turf_decal/tile/yellow/anticorner{
	dir = 4
	},
/turf/open/indestructible/dark/smooth_large,
/area/deathmatch/fullbright)
"F" = (
/obj/effect/turf_decal/tile/yellow/half,
/turf/open/indestructible/dark/smooth_large,
/area/deathmatch/fullbright)
"H" = (
/obj/effect/turf_decal/tile/yellow/anticorner{
	dir = 1
	},
/turf/open/indestructible/dark/smooth_large,
/area/deathmatch/fullbright)
"I" = (
/obj/effect/turf_decal/tile/yellow/anticorner{
	dir = 8
	},
/turf/open/indestructible/dark/smooth_large,
/area/deathmatch/fullbright)
"K" = (
/obj/effect/turf_decal/tile/yellow/half{
	dir = 8
	},
/turf/open/indestructible/dark/smooth_large,
/area/deathmatch/fullbright)
"M" = (
/obj/machinery/field/generator/starts_on,
/obj/structure/cable,
/obj/effect/turf_decal/tile/dark_red/full,
/turf/open/indestructible/dark/smooth_large,
/area/deathmatch/fullbright)
"N" = (
/turf/open/chasm/true,
/area/deathmatch/fullbright)
"W" = (
/obj/effect/turf_decal/tile/dark_red/anticorner{
	dir = 8
	},
/turf/open/indestructible/dark/smooth_large,
/area/deathmatch/fullbright)
"Y" = (
/obj/effect/turf_decal/tile/yellow/anticorner,
/turf/open/indestructible/dark/smooth_large,
/area/deathmatch/fullbright)

(1,1,1) = {"
c
c
c
c
c
c
c
c
c
c
c
c
c
c
c
c
c
c
c
c
e
c
c
c
c
c
c
c
c
c
c
c
c
c
c
c
c
c
c
c
c
"}
(2,1,1) = {"
c
N
N
N
N
N
N
N
N
N
N
N
N
N
N
N
N
N
N
N
y
N
N
N
N
N
N
N
N
N
N
N
N
N
N
N
N
N
N
N
c
"}
(3,1,1) = {"
c
N
N
N
N
N
N
N
N
N
N
N
N
N
N
N
N
N
N
N
p
N
N
N
N
N
N
N
N
N
N
N
N
N
N
N
N
N
N
N
c
"}
(4,1,1) = {"
c
N
N
N
N
N
N
N
N
N
N
N
N
N
N
N
N
N
N
N
p
N
N
N
N
N
N
N
N
N
N
N
N
N
N
N
N
N
N
N
c
"}
(5,1,1) = {"
c
N
N
N
z
r
r
r
r
r
r
r
M
r
r
r
r
r
r
r
M
r
r
r
r
r
r
r
M
r
r
r
r
r
r
r
z
N
N
N
c
"}
(6,1,1) = {"
c
N
N
N
r
A
a
f
a
f
a
f
a
f
a
f
a
f
a
f
a
f
a
f
a
f
a
f
a
f
a
f
a
f
a
W
r
N
N
N
c
"}
(7,1,1) = {"
c
N
N
N
r
a
a
a
a
a
a
a
a
a
a
a
a
a
a
a
a
a
a
a
a
a
a
a
a
a
a
a
a
a
a
a
r
N
N
N
c
"}
(8,1,1) = {"
c
N
N
N
r
w
a
a
u
a
u
a
u
a
u
a
u
a
u
a
u
a
u
a
u
a
u
a
u
a
u
a
u
a
a
q
r
N
N
N
c
"}
(9,1,1) = {"
c
N
N
N
r
a
a
F
s
b
b
b
b
b
b
b
s
b
b
b
b
b
b
b
s
b
b
b
b
b
b
b
s
h
a
a
r
N
N
N
c
"}
(10,1,1) = {"
c
N
N
N
r
w
a
a
b
H
a
K
a
K
a
K
a
K
a
K
a
K
a
K
a
K
a
K
a
K
a
I
b
a
a
q
r
N
N
N
c
"}
(11,1,1) = {"
c
N
N
N
r
a
a
F
b
a
a
a
a
a
a
a
a
a
a
a
a
a
a
a
a
a
a
a
a
a
a
a
b
h
a
a
r
N
N
N
c
"}
(12,1,1) = {"
c
N
N
N
r
w
a
a
b
h
a
a
a
a
a
a
a
a
a
a
a
a
a
a
a
a
a
a
a
a
a
F
b
a
a
q
r
N
N
N
c
"}
(13,1,1) = {"
c
N
N
N
M
a
a
F
b
a
a
a
a
a
a
a
a
a
a
a
o
a
a
a
a
a
a
a
a
a
a
a
b
h
a
a
M
N
N
N
c
"}
(14,1,1) = {"
c
N
N
N
r
w
a
a
b
h
a
a
a
a
a
a
a
a
a
a
a
a
a
a
a
a
a
a
a
a
a
F
b
a
a
q
r
N
N
N
c
"}
(15,1,1) = {"
c
N
N
N
r
a
a
F
b
a
a
a
a
a
a
a
a
a
a
a
a
a
a
a
a
a
a
a
a
a
a
a
b
h
a
a
r
N
N
N
c
"}
(16,1,1) = {"
c
N
N
N
r
w
a
a
b
h
a
a
a
a
a
o
a
a
a
a
a
a
a
a
a
o
a
a
a
a
a
F
b
a
a
q
r
N
N
N
c
"}
(17,1,1) = {"
c
N
N
N
r
a
a
F
s
a
a
a
a
a
a
a
a
a
a
a
a
a
a
a
a
a
a
a
a
a
a
a
s
h
a
a
r
N
N
N
c
"}
(18,1,1) = {"
c
N
N
N
r
w
a
a
b
h
a
a
a
a
a
a
a
a
a
a
a
a
a
a
a
a
a
a
a
a
a
F
b
a
a
q
r
N
N
N
c
"}
(19,1,1) = {"
c
N
N
N
r
a
a
F
b
a
a
a
a
a
a
a
a
a
a
a
a
a
a
a
a
a
a
a
a
a
a
a
b
h
a
a
r
N
N
N
c
"}
(20,1,1) = {"
c
N
N
N
r
w
a
a
b
h
a
a
a
a
a
a
a
a
a
a
a
a
a
a
a
a
a
a
a
a
a
F
b
a
a
q
r
N
N
N
c
"}
(21,1,1) = {"
e
y
p
p
M
a
a
F
b
a
a
a
o
a
a
a
a
a
a
a
i
a
a
a
a
a
a
a
o
a
a
a
b
h
a
a
M
p
p
y
e
"}
(22,1,1) = {"
c
N
N
N
r
w
a
a
b
h
a
a
a
a
a
a
a
a
a
a
a
a
a
a
a
a
a
a
a
a
a
F
b
a
a
q
r
N
N
N
c
"}
(23,1,1) = {"
c
N
N
N
r
a
a
F
b
a
a
a
a
a
a
a
a
a
a
a
a
a
a
a
a
a
a
a
a
a
a
a
b
h
a
a
r
N
N
N
c
"}
(24,1,1) = {"
c
N
N
N
r
w
a
a
b
h
a
a
a
a
a
a
a
a
a
a
a
a
a
a
a
a
a
a
a
a
a
F
b
a
a
q
r
N
N
N
c
"}
(25,1,1) = {"
c
N
N
N
r
a
a
F
s
a
a
a
a
a
a
a
a
a
a
a
a
a
a
a
a
a
a
a
a
a
a
a
s
h
a
a
r
N
N
N
c
"}
(26,1,1) = {"
c
N
N
N
r
w
a
a
b
h
a
a
a
a
a
o
a
a
a
a
a
a
a
a
a
o
a
a
a
a
a
F
b
a
a
q
r
N
N
N
c
"}
(27,1,1) = {"
c
N
N
N
r
a
a
F
b
a
a
a
a
a
a
a
a
a
a
a
a
a
a
a
a
a
a
a
a
a
a
a
b
h
a
a
r
N
N
N
c
"}
(28,1,1) = {"
c
N
N
N
r
w
a
a
b
h
a
a
a
a
a
a
a
a
a
a
a
a
a
a
a
a
a
a
a
a
a
F
b
a
a
q
r
N
N
N
c
"}
(29,1,1) = {"
c
N
N
N
M
a
a
F
b
a
a
a
a
a
a
a
a
a
a
a
o
a
a
a
a
a
a
a
a
a
a
a
b
h
a
a
M
N
N
N
c
"}
(30,1,1) = {"
c
N
N
N
r
w
a
a
b
h
a
a
a
a
a
a
a
a
a
a
a
a
a
a
a
a
a
a
a
a
a
F
b
a
a
q
r
N
N
N
c
"}
(31,1,1) = {"
c
N
N
N
r
a
a
F
b
a
a
a
a
a
a
a
a
a
a
a
a
a
a
a
a
a
a
a
a
a
a
a
b
h
a
a
r
N
N
N
c
"}
(32,1,1) = {"
c
N
N
N
r
w
a
a
b
D
a
u
a
u
a
u
a
u
a
u
a
u
a
u
a
u
a
u
a
u
a
Y
b
a
a
q
r
N
N
N
c
"}
(33,1,1) = {"
c
N
N
N
r
a
a
F
s
b
b
b
b
b
b
b
s
b
b
b
b
b
b
b
s
b
b
b
b
b
b
b
s
h
a
a
r
N
N
N
c
"}
(34,1,1) = {"
c
N
N
N
r
w
a
a
K
a
K
a
K
a
K
a
K
a
K
a
K
a
K
a
K
a
K
a
K
a
K
a
K
a
a
q
r
N
N
N
c
"}
(35,1,1) = {"
c
N
N
N
r
a
a
a
a
a
a
a
a
a
a
a
a
a
a
a
a
a
a
a
a
a
a
a
a
a
a
a
a
a
a
a
r
N
N
N
c
"}
(36,1,1) = {"
c
N
N
N
r
l
a
x
a
x
a
x
a
x
a
x
a
x
a
x
a
x
a
x
a
x
a
x
a
x
a
x
a
x
a
t
r
N
N
N
c
"}
(37,1,1) = {"
c
N
N
N
z
r
r
r
r
r
r
r
M
r
r
r
r
r
r
r
M
r
r
r
r
r
r
r
M
r
r
r
r
r
r
r
z
N
N
N
c
"}
(38,1,1) = {"
c
N
N
N
N
N
N
N
N
N
N
N
N
N
N
N
N
N
N
N
p
N
N
N
N
N
N
N
N
N
N
N
N
N
N
N
N
N
N
N
c
"}
(39,1,1) = {"
c
N
N
N
N
N
N
N
N
N
N
N
N
N
N
N
N
N
N
N
p
N
N
N
N
N
N
N
N
N
N
N
N
N
N
N
N
N
N
N
c
"}
(40,1,1) = {"
c
N
N
N
N
N
N
N
N
N
N
N
N
N
N
N
N
N
N
N
y
N
N
N
N
N
N
N
N
N
N
N
N
N
N
N
N
N
N
N
c
"}
(41,1,1) = {"
c
c
c
c
c
c
c
c
c
c
c
c
c
c
c
c
c
c
c
c
e
c
c
c
c
c
c
c
c
c
c
c
c
c
c
c
c
c
c
c
c
"}
